111111111111111
100000000000001
101K11111111111
1K11111LLLLLLL1
1K11L0001111111
1K1111101111111
101111101101111
100000000LLLLL1
111111101111111
1111111L1111111