111111111111111111111111
100000100000000000100011
101110101101101110101101
10111KKK110110111KKK1101
101111111101101111111101
101110101101101110101101
10LLL010000110LLL0100001
101111111101101111111101
101111111101101111111101
101111111101101111111101
101111111101101111111101
10LLL010000110LLL0100001
101110101101101110101101
10111K1K110110111K0K1101
111111111111111111111111
